//MAP CONVERTED BY dmm2tgm.py THIS HEADER COMMENT PREVENTS RECONVERSION, DO NOT REMOVE
"ab" = (
/turf/closed/wall/solaris/reinforced,
/area/bigredv2/outside/admin_building)
"ac" = (
/obj/effect/acid_hole,
/turf/closed/wall/solaris,
/area/bigredv2/outside/admin_building)
"ad" = (
/obj/structure/window/framed/solaris,
/turf/open/floor/plating,
/area/bigredv2/outside/admin_building)
"ae" = (
/turf/closed/wall/solaris,
/area/bigredv2/outside/admin_building)
"aj" = (
/obj/structure/window_frame/solaris,
/obj/item/shard,
/turf/open/floor/plating,
/area/bigredv2/outside/admin_building)
"ay" = (
/turf/open/floor{
	icon_state = "dark"
	},
/area/bigredv2/outside/admin_building)
"aG" = (
/obj/structure/pipes/standard/simple/hidden/green{
	dir = 4
	},
/turf/open/floor{
	icon_state = "darkredcorners2"
	},
/area/bigredv2/outside/admin_building)
"aH" = (
/obj/structure/pipes/standard/simple/hidden/green{
	dir = 4
	},
/obj/effect/decal/cleanable/blood/xeno,
/turf/open/floor{
	icon_state = "darkred2"
	},
/area/bigredv2/outside/admin_building)
"aT" = (
/obj/effect/decal/cleanable/blood,
/turf/open/floor{
	icon_state = "dark"
	},
/area/bigredv2/outside/admin_building)
"bf" = (
/obj/structure/pipes/standard/simple/hidden/green{
	dir = 4
	},
/turf/open/floor{
	icon_state = "dark"
	},
/area/bigredv2/outside/admin_building)
"bh" = (
/obj/structure/pipes/standard/simple/hidden/green{
	dir = 4
	},
/obj/structure/machinery/door/airlock/almayer/command/colony{
	name = "\improper Operations Office"
	},
/turf/open/floor{
	icon_state = "wood"
	},
/area/bigredv2/outside/admin_building)
"bp" = (
/obj/structure/machinery/vending/coffee,
/turf/open/floor,
/area/bigredv2/outside/admin_building)
"br" = (
/turf/open/floor{
	icon_state = "darkred2"
	},
/area/bigredv2/outside/admin_building)
"bv" = (
/obj/effect/landmark/corpsespawner/wygoon,
/turf/open/floor/carpet,
/area/bigredv2/outside/admin_building)
"bx" = (
/obj/item/ammo_magazine/rifle{
	current_rounds = 0;
	pixel_x = -9;
	pixel_y = 7
	},
/turf/open/floor{
	icon_state = "wood"
	},
/area/bigredv2/outside/admin_building)
"bV" = (
/obj/item/ammo_magazine/pistol/rubber{
	current_rounds = 0
	},
/turf/open/floor{
	icon_state = "wood"
	},
/area/bigredv2/outside/admin_building)
"cA" = (
/obj/structure/surface/table,
/obj/item/storage/firstaid/regular/empty,
/turf/open/floor/carpet,
/area/bigredv2/outside/admin_building)
"ed" = (
/obj/structure/surface/table,
/obj/item/device/radio/marine,
/obj/effect/landmark/objective_landmark/medium,
/obj/item/weapon/gun/pistol/m4a3/training{
	name = "dented M4A3 service pistol"
	},
/obj/item/ammo_magazine/pistol/rubber,
/turf/open/floor/carpet,
/area/bigredv2/outside/admin_building)
"ew" = (
/obj/item/storage/secure/briefcase,
/turf/open/floor/carpet,
/area/bigredv2/outside/admin_building)
"ey" = (
/obj/item/ammo_magazine/rifle{
	current_rounds = 0
	},
/turf/open/floor{
	icon_state = "wood"
	},
/area/bigredv2/outside/admin_building)
"eH" = (
/obj/effect/spawner/random/toolbox,
/obj/structure/platform_decoration,
/turf/open/floor{
	icon_state = "dark"
	},
/area/bigredv2/outside/admin_building)
"eJ" = (
/obj/effect/decal/cleanable/blood,
/obj/item/tool/weldingtool,
/turf/open/floor/carpet,
/area/bigredv2/outside/admin_building)
"eS" = (
/obj/structure/bed/chair/comfy/blue{
	dir = 4
	},
/turf/open/floor/carpet,
/area/bigredv2/outside/admin_building)
"gy" = (
/obj/structure/pipes/standard/simple/hidden/green{
	dir = 4
	},
/turf/open/floor{
	dir = 4;
	icon_state = "darkred2"
	},
/area/bigredv2/outside/admin_building)
"hM" = (
/obj/item/ammo_magazine/rifle{
	current_rounds = 0;
	pixel_x = -8;
	pixel_y = 9
	},
/obj/structure/pipes/standard/simple/hidden/green{
	dir = 4
	},
/turf/open/floor{
	icon_state = "wood"
	},
/area/bigredv2/outside/admin_building)
"iP" = (
/obj/structure/machinery/door/airlock/almayer/command/colony{
	dir = 1;
	name = "\improper Operations Meeting Room"
	},
/turf/open/floor{
	icon_state = "delivery"
	},
/area/bigredv2/outside/admin_building)
"kf" = (
/obj/structure/bed/chair/comfy/blue{
	dir = 8
	},
/turf/open/floor/carpet,
/area/bigredv2/outside/admin_building)
"ki" = (
/obj/structure/pipes/standard/simple/hidden/green{
	dir = 4
	},
/obj/structure/machinery/door/airlock/almayer/command/colony{
	name = "\improper Operations Meeting Room"
	},
/obj/structure/pipes/standard/simple/hidden/green{
	dir = 4
	},
/turf/open/floor,
/area/bigredv2/outside/admin_building)
"lH" = (
/obj/structure/pipes/standard/simple/hidden/green,
/obj/structure/machinery/light{
	dir = 8
	},
/turf/open/floor{
	dir = 8;
	icon_state = "darkred2"
	},
/area/bigredv2/outside/admin_building)
"lV" = (
/obj/structure/reagent_dispensers/fueltank,
/turf/open/floor/carpet,
/area/bigredv2/outside/admin_building)
"np" = (
/obj/structure/window/framed/solaris/reinforced,
/obj/structure/machinery/door/poddoor/shutters/almayer{
	id = "Operations";
	name = "\improper Operations Shutters"
	},
/turf/open/floor/plating,
/area/bigredv2/outside/admin_building)
"nP" = (
/obj/structure/barricade/metal/wired{
	dir = 4
	},
/obj/item/ammo_magazine/pistol/rubber{
	current_rounds = 0
	},
/turf/open/floor{
	icon_state = "wood"
	},
/area/bigredv2/outside/admin_building)
"nQ" = (
/obj/structure/platform_decoration{
	dir = 8
	},
/obj/effect/decal/cleanable/blood/xeno,
/turf/open/floor{
	icon_state = "dark"
	},
/area/bigredv2/outside/admin_building)
"oe" = (
/turf/open/floor{
	dir = 10;
	icon_state = "darkred2"
	},
/area/bigredv2/outside/admin_building)
"td" = (
/obj/item/ammo_box/magazine{
	num_of_magazines = 2
	},
/obj/item/ammo_magazine/rifle{
	current_rounds = 0;
	pixel_x = -8;
	pixel_y = 13
	},
/obj/item/ammo_magazine/rifle{
	current_rounds = 0;
	pixel_x = 14;
	pixel_y = 17
	},
/turf/open/floor{
	icon_state = "wood"
	},
/area/bigredv2/outside/admin_building)
"tF" = (
/obj/item/device/radio/intercom{
	freerange = 1;
	frequency = 1469;
	name = "General Listening Channel";
	pixel_x = 30
	},
/turf/open/floor{
	dir = 6;
	icon_state = "darkred2"
	},
/area/bigredv2/outside/admin_building)
"tV" = (
/turf/open/floor{
	dir = 4;
	icon_state = "darkred2"
	},
/area/bigredv2/outside/admin_building)
"ue" = (
/obj/structure/bed/chair/comfy/black,
/turf/open/floor/carpet,
/area/bigredv2/outside/admin_building)
"up" = (
/obj/structure/platform{
	dir = 1
	},
/turf/open/floor{
	icon_state = "dark"
	},
/area/bigredv2/outside/admin_building)
"uD" = (
/obj/structure/platform_decoration{
	dir = 4
	},
/turf/open/floor{
	icon_state = "dark"
	},
/area/bigredv2/outside/admin_building)
"uS" = (
/obj/item/ammo_magazine/rifle/rubber{
	current_rounds = 3;
	pixel_x = -3;
	pixel_y = -6
	},
/turf/open/floor/carpet,
/area/bigredv2/outside/admin_building)
"vr" = (
/obj/structure/platform,
/obj/structure/flora/jungle/planttop1{
	pixel_y = 10
	},
/turf/open/floor{
	icon_state = "dark"
	},
/area/bigredv2/outside/admin_building)
"wY" = (
/obj/structure/platform{
	dir = 4
	},
/turf/open/floor{
	icon_state = "dark"
	},
/area/bigredv2/outside/admin_building)
"As" = (
/obj/structure/machinery/light{
	dir = 8
	},
/obj/effect/decal/cleanable/blood{
	icon_state = "gib6"
	},
/turf/open/floor{
	icon_state = "wood"
	},
/area/bigredv2/outside/admin_building)
"BT" = (
/obj/item/ammo_magazine/rifle/rubber{
	current_rounds = 0;
	pixel_y = 11
	},
/turf/open/floor{
	icon_state = "wood"
	},
/area/bigredv2/outside/admin_building)
"Cr" = (
/obj/structure/pipes/standard/simple/hidden/green,
/obj/structure/barricade/sandbags/wired,
/turf/open/floor{
	dir = 8;
	icon_state = "darkred2"
	},
/area/bigredv2/outside/admin_building)
"Hb" = (
/obj/structure/platform{
	dir = 8
	},
/turf/open/floor{
	icon_state = "dark"
	},
/area/bigredv2/outside/admin_building)
"Hm" = (
/obj/structure/bed/chair/comfy/blue{
	dir = 8
	},
/obj/structure/pipes/standard/simple/hidden/green{
	dir = 4
	},
/obj/effect/landmark/corpsespawner/wygoon,
/turf/open/floor/carpet,
/area/bigredv2/outside/admin_building)
"Ii" = (
/obj/structure/barricade/sandbags/wired,
/turf/open/floor{
	dir = 4;
	icon_state = "darkred2"
	},
/area/bigredv2/outside/admin_building)
"IW" = (
/obj/structure/pipes/standard/manifold/hidden/green{
	dir = 8
	},
/turf/open/floor{
	dir = 8;
	icon_state = "darkred2"
	},
/area/bigredv2/outside/admin_building)
"Kd" = (
/obj/item/ammo_box/magazine/ext{
	num_of_magazines = 1
	},
/turf/open/floor{
	icon_state = "wood"
	},
/area/bigredv2/outside/admin_building)
"Kv" = (
/obj/structure/pipes/standard/simple/hidden/green{
	dir = 4
	},
/obj/effect/decal/cleanable/blood,
/turf/open/floor/carpet,
/area/bigredv2/outside/admin_building)
"KX" = (
/obj/structure/machinery/light{
	dir = 4
	},
/obj/item/storage/toolbox/syndicate,
/turf/open/floor{
	dir = 4;
	icon_state = "darkred2"
	},
/area/bigredv2/outside/admin_building)
"Lr" = (
/obj/structure/barricade/metal/wired{
	dir = 4
	},
/turf/open/floor{
	icon_state = "wood"
	},
/area/bigredv2/outside/admin_building)
"LS" = (
/obj/structure/barricade/metal/wired{
	dir = 4;
	icon_state = "metal_2"
	},
/turf/open/floor{
	icon_state = "wood"
	},
/area/bigredv2/outside/admin_building)
"Ng" = (
/obj/structure/flora/jungle/plantbot1{
	pixel_y = 10
	},
/turf/open/jungle,
/area/bigredv2/outside/admin_building)
"Ny" = (
/obj/effect/landmark/survivor_spawner,
/obj/structure/platform_decoration{
	dir = 1
	},
/turf/open/floor{
	icon_state = "dark"
	},
/area/bigredv2/outside/admin_building)
"NY" = (
/obj/structure/pipes/standard/simple/hidden/green,
/turf/open/floor{
	dir = 8;
	icon_state = "darkred2"
	},
/area/bigredv2/outside/admin_building)
"Ol" = (
/obj/effect/landmark/corpsespawner/wygoon,
/turf/open/floor{
	icon_state = "wood"
	},
/area/bigredv2/outside/admin_building)
"Pb" = (
/obj/structure/pipes/standard/simple/hidden/green,
/obj/effect/decal/cleanable/blood/xeno,
/turf/open/floor{
	dir = 8;
	icon_state = "darkredcorners2"
	},
/area/bigredv2/outside/admin_building)
"PO" = (
/obj/item/ammo_magazine/pistol/rubber{
	current_rounds = 0
	},
/turf/open/floor/carpet,
/area/bigredv2/outside/admin_building)
"Qy" = (
/obj/structure/surface/table,
/obj/item/ammo_magazine/rifle/rubber,
/turf/open/floor/carpet,
/area/bigredv2/outside/admin_building)
"QE" = (
/obj/structure/surface/table,
/obj/structure/pipes/vents/pump{
	dir = 4
	},
/obj/item/clothing/head/helmet/marine/veteran/pmc/leader,
/turf/open/floor/carpet,
/area/bigredv2/outside/admin_building)
"QZ" = (
/obj/structure/window/framed/solaris/reinforced,
/obj/structure/machinery/door/poddoor/shutters/almayer{
	dir = 4;
	id = "Operations";
	name = "\improper Operations Shutters"
	},
/turf/open/floor{
	icon_state = "darkred2"
	},
/area/bigredv2/outside/admin_building)
"RP" = (
/obj/item/ammo_magazine/rifle/rubber{
	current_rounds = 0;
	pixel_x = 5;
	pixel_y = -5
	},
/turf/open/floor/carpet,
/area/bigredv2/outside/admin_building)
"Sn" = (
/obj/item/weapon/gun/rifle/m41a/corporate{
	current_mag = /obj/item/ammo_magazine/rifle/rubber;
	desc = "A Weyland-Yutani creation, this M41A MK2 comes equipped in corporate white. Uses 10x24mm caseless ammunition. It seems to be pretty battered and broken up.";
	name = "battered M41A pulse rifle MK2";
	pixel_x = 4
	},
/turf/open/floor/carpet,
/area/bigredv2/outside/admin_building)
"Ty" = (
/turf/open/floor{
	icon_state = "wood"
	},
/area/bigredv2/outside/admin_building)
"US" = (
/obj/structure/pipes/standard/simple/hidden/green,
/obj/effect/landmark/crap_item,
/turf/open/floor{
	dir = 8;
	icon_state = "darkred2"
	},
/area/bigredv2/outside/admin_building)
"VH" = (
/obj/structure/surface/table,
/obj/structure/prop/server_equipment/laptop/on,
/turf/open/floor/carpet,
/area/bigredv2/outside/admin_building)
"VM" = (
/obj/item/ammo_magazine/rifle/rubber{
	current_rounds = 0;
	pixel_x = -6;
	pixel_y = -4
	},
/turf/open/floor/carpet,
/area/bigredv2/outside/admin_building)
"VS" = (
/obj/structure/machinery/light{
	dir = 8
	},
/obj/item/ammo_magazine/rifle{
	current_rounds = 0;
	pixel_x = -2;
	pixel_y = -10
	},
/obj/item/ammo_box/magazine/m4a3{
	num_of_magazines = 2
	},
/turf/open/floor{
	icon_state = "wood"
	},
/area/bigredv2/outside/admin_building)
"YT" = (
/turf/open/floor/carpet,
/area/bigredv2/outside/admin_building)
"Ze" = (
/obj/structure/pipes/standard/manifold/hidden/green,
/turf/open/floor{
	icon_state = "dark"
	},
/area/bigredv2/outside/admin_building)

(1,1,1) = {"
QZ
ab
ab
ab
ab
ab
ab
ab
ab
ab
"}
(2,1,1) = {"
br
ac
As
Ol
BT
Ty
ey
VS
Kd
ab
"}
(3,1,1) = {"
br
aj
VM
PO
eS
ew
eS
YT
td
bp
"}
(4,1,1) = {"
br
aj
ue
VH
ed
cA
Qy
QE
Ty
bx
"}
(5,1,1) = {"
br
ae
Sn
kf
YT
kf
RP
Hm
Ty
Ty
"}
(6,1,1) = {"
ay
iP
bv
eJ
lV
uS
YT
Kv
Ty
bV
"}
(7,1,1) = {"
br
ae
LS
Lr
Lr
nP
Lr
hM
Ty
Ty
"}
(8,1,1) = {"
br
ae
ae
ad
ad
ad
ae
ki
ae
ae
"}
(9,1,1) = {"
Pb
lH
NY
IW
Cr
NY
US
Ze
oe
np
"}
(10,1,1) = {"
eH
wY
nQ
bf
ay
aT
ay
bf
ay
np
"}
(11,1,1) = {"
vr
Ng
up
aG
Ii
KX
tV
gy
tF
np
"}
(12,1,1) = {"
Ny
Hb
uD
aH
ae
ae
ae
bh
ae
ae
"}
